============
|A| w     x|
|R|  ==== K|
|E|^ | D   |
|N|^ |    +|
|A|^    | +|
|#|^  x |o+|
|0|oo==== +|
|1|x   p  O|
============