==========
| w     x|
|  ====  |
|^ | #   |
|^ |    +|
|^    |w+|
|^  x | +|
|  ==== +|
|    p   |
==========