============
|A| w     x|
|R|  ====  |
|E|^ | #   |
|N|^ |    +|
|A|^    |w+|
|#|^  x | +|
|0|  ==== +|
|1|    p   |
============