============
|A| w     x|
|R|  ====  |
|E|^ | #   |
|N|^ |    +|
|A|^    | +|
|#|^  x |o+|
|0|oo==== +|
|1|x   p  O|
============