=====================
|A|         #      x |
|R| == x========  == |
|E|                  |
|N| == | = == =x| == |
|A|    |        |    |
|#| == | x  p   | == |
|0|    |========|    |
|2| x              x |
======================