====================
|                x |
| == x========  == |
|                  |
| == | = == =x| == |
|    |        |    |
| == | x  p   | == |
|    |========|    |
| x              x |
====================