==========
|       x|
|  ====  |
|  |     |
|  |     |
|     |  |
|   x |  |
|  ====  |
|    p   |
==========