============
|T|w    |w |
|E| === |  |
|S|     |  |
|T|p     ^ |
============