============
|T|     w D|
|U| |======|
|T|       w|
|0|==d==d==|
|R|        |
|I|)      k|
|A|=      =|
|L|^  p   !|
============
