============
|T|OOK|   <|
|U|   | ===|
|T| OO|    |
|0|  O|=== |
|R|O O|    |
|I|O  | ==D|
|A|OO |    |
|L|>  | p !|
============
