============
|T|    d  D|
|U|d|x|====|
|T| |x|x  k|
|0| |+|x x+|
|R|K|x|x  x|
|I|=|x|xx x|
|A|+       |
|L|   p   !|
============
