============
|T| c c c  |
|U|c=====|c|
|T| | c c| |
|0|c|c|c |^|
|R| c | c|K|
|I|====c ==|
|A|wd   c  |
|L|D|  p  !|
============
