============
|T|    d  #|
|U| | |====|
|T| |x|x  k|
|0| |x|x xx|
|R| |x|x  x|
|I| |x|xx x|
|A|        |
|L|   p !  |
============
