============
|T|        |
|U|   #    |
|T|        |
|0|===d====|
|R|        |
|I|  |k|!  |
|A|        |
|L|   p    |
============
