============
|T|        |
|U|   K    |
|T|        |
|0|==   ===|
|R|      |D|
|I|   !  | |
|A|      |d|
|L|   p    |
============
