============
|T|w      D|
|U| |======|
|T|       +|
|0|==d==d==|
|R|[       |
|I|  |k|!  |
|A|        |
|L|^  p   +|
============
