============
|W|~>|##|<~|
|E|==|  |==|
|L|        |
|C| ====== |
|0| |HAVE| |
|M| |FUN!| |
|E| ====== |
|!|   p    |
============