============
|W|~>|##|<~|
|E|==|  |==|
|L|        |
|C| ====== |
|0| |HAVE| |
|M| |FUN!|c|
|E| ======c|
|!|   p ) +|
============